11111111111111111111111111
10000000000110000011000001
1P00C0000C0010C000010eC001
1CE1000011C1100010010Ce001
100000C00C1110e000010e0001
100000e00e1000C00001000001
100000e0011000e000010e0001
1e0000C00e00C00111110Ee001
100000e00000e0010000Ce0001
100000Ce0e00C0010C00e00001
100000e0000eCe000e00C00001
100000e00000Ce000e00000001
11111111111111111111111111