111111
10e101
1P0001
1CE101
111111