1111111111111111111111111111111111
1E00000e0000000C00000C000000000001
10100101001000e0101001000000010101
1010010010101010001001000C00010101
1P0000000C00Ce000e0000C000000000C1
1111111111111111111111111111111111